00000000000000001100000000000000000000000000ww000000111100000w00000w001111111111
0000000000000a000000000000000000000000000000000000001111000000w0000w001111111111
0000000000000000000000g0000000000000000000000000000011111000000000w0001111111111
00000w00000113452210002111150000000000000000001110000000100011111w00001111111111
0000000000000000000000001110000000001000000000000000w112110000113241001111111111
0000000000000000000000000000000000000000000w000000000000000000111110001111111111
00000000000a0000a000000000000000000000000000000000000w00000000111110001111111111
00000000000000000000000000000000g00000000000000000000000000000111110w01111111111
0000000000000000w000a0000a00000000000000000000000000000000000011111w001111111111
000000000000000a000000000000000000000000000000000000w000000000111110001111111111
000w0000000111221110001344110000000000000000000000113310001000w00010101111111111
0000000000000000000000w00w0000001111111000g0000010000000001100000000111111111111
000000000001100w011000111111000000000000g0000g0000000000000000000000001111111111