11111111110000000000110w0w0011114444441111111111111144444411330f00f0331100000011
1100000000000a00000011000000001300000000110g000000130000000011000000001111111111
000000001100a00000k1000000011100000001110000w001110000000111w0P00P01111113311111
11111111111113333111112000021111102201111120000211111022011111200002111113344111
11111111110331111330003111130000k4444k0000044440000031111300033111133w1111111111