000000000000f00340000000022110000000w0000013311000001221111w01111111111111111111
00000000000012000f00000000000000P0w0w0000013431P00001123115001112313311111111111
000000000000g0000000000000000000000000000012211000000000000001222441111111111111
0000000000000000111000a000000f000000000000000000000000000000w0P3w00P011111111111
0000000000000001122000g00000f000000000000000000000000044w0000wP33322w01111111111
000000000000000112200f0000011000000000000000000000000w440000wP033322w01111111111
000000000000w000w0000111331111000000000f1122111100000000330000w00000001111111111
00000000000000w00w000111331111000000000f00221122000000012100033w0000001111111111
000000000000000000f0000w000000000110100002125110000113411000111210w0001111111111
000000000000000000000000w00000000330200004411112200125521000111210w0001221111111
0000000000000600000000000000f000000000000045011w00w01111100011111333001111111111
000000w0000000001110000001551000110111110P110w0000111211110001134311001111111111
f0000000000110w0111f001111110000000000000111000000011000111100P00w00001111111111
00w0000000011244211000111111f00000000000011100000001100011110w0w00P0001111111111
0000000000011111111000145541f00w000000000111000w000110001111000330P0w01111111111
000000w00002115511200f011110000000000000011100000002200033330Pw00000001111111111
000000000001100w011000111111f00000000000g0000g0000000000000000000000001111111111
0000000w000111431110001122f0000000000000g000000000000000000000000000001111111111
000000000001112211100f112211f0000000000000000g00000000000000w0000000001111111111
000000000001113001f0011110010041111011000000001100011111111104110011141111111111