00w0000000001110100100000000000000w0000000033300000000110000P0000000P01110000111
000w000000001110200100022000000000w000000001110000000000000000P0000w001110000111
0000000000111000111100000w00000001110000000000000000000000P000100001101111000111
0000000000111000111100a000000000000000000000000000000000000000100001101111000111
000000w000000011100000000010000000000000000P0Pw000002111110000000001101111110111
000000w0000000113000000003100000000000000002000P00001101110001200001101111330111
00000000000000112000000005112000000000000132001240011100111015500000011111001111
00000000000000030000000022000000011110000000w0000000001100P00P100003101111001111
000000000000001100000021001P0000000002000510000130011100111011500000011111001111
000000000000a00000000000000000000000000000w0P0P000001113110001100000001111000011
0000000000a0000a0000000000000000000000000g00000000000000000000000000001111114041
000000000000a000000000000000000000000000000000P000004431110000000001201111110111
000000000000a0000000000000000000000000000000000000002022030000100001001111001111